county;GEN;EWZ;BL;popdens;pop_share65plus;East;SVB_Arbeitsort;Einpendler;SVB_Wohnort;Auspendler;Pendlersaldo;Einpendler_plus_Auspendler;SVB_Wohnort_plus_SVB_Arbeitsort;comm_index;TourAnkuenfte2018;TourPer1000;Lebenserwartung;PM10;NO2
01001;Flensburg;89504;Schleswig-Holstein;1577,71902;20,09742581;0;44607;23363;32323;11096;12267;34459;76930;0,447926687;188390;2104,822131;77,95;19;27
01002;Kiel;247548;Schleswig-Holstein;2086,371681;18,56973193;0;125483;61487;91908;27950;33537;89437;217391;0,411410776;385648;1557,871605;79,89;22;39
01003;L++beck;217198;Schleswig-Holstein;1014,043606;23,20371274;0;99053;43805;80035;24823;18982;68628;179088;0,383208255;754190;3472,361624;79,73;20;26
01004;Neum++nster;79487;Schleswig-Holstein;1109,224114;22,58482519;0;40641;22314;30015;11699;10615;34013;70656;0,4813887;93659;1178,293306;79,07;15;9
01051;Dithmarschen;133210;Schleswig-Holstein;93,27255668;24,74438856;0;42518;6825;48664;12991;-6166;19816;91182;0,217323595;350821;2633,593574;79,32;19;22
01053;Herzogtum Lauenburg;197264;Schleswig-Holstein;156,1782007;22,36089707;0;48811;18792;75481;45481;-26689;64273;124292;0,517112928;204571;1037,041731;80,92;15;10
01054;Nordfriesland;165507;Schleswig-Holstein;79,43586125;24,17601672;0;60989;10178;63047;12250;-2072;22428;124036;0,180818472;1638001;9896,86841;80,26;16;9
01055;Ostholstein;200581;Schleswig-Holstein;143,9921034;27,50659335;0;62095;16308;73403;27625;-11317;43933;135498;0,324233568;1787773;8912,972814;80,47;20;26
01056;Pinneberg;314391;Schleswig-Holstein;473,2879703;22,107185;0;92689;35147;128499;70989;-35842;106136;221188;0,4798452;279448;888,8549609;81,1;20;29
01057;Pl+Ân;128647;Schleswig-Holstein;118,7262357;26,12653229;0;27954;10503;46211;28764;-18261;39267;74165;0,529454594;291330;2264,568937;81,5;22;39
01058;Rendsburg-Eckernf+Ârde;272775;Schleswig-Holstein;124,5673081;23,51131885;0;79903;27975;100055;48145;-20170;76120;179958;0,422987586;475986;1744,976629;80,99;16;33
01059;Schleswig-Flensburg;200025;Schleswig-Holstein;96,56838843;23,848019;0;56524;16894;70539;30921;-14027;47815;127063;0,37630939;416854;2084,009499;80,34;16;9
01060;Segeberg;276032;Schleswig-Holstein;205,3091553;21,75508637;0;93031;40824;113194;61004;-20180;101828;206225;0,493771366;297986;1079,534257;81,13;15;9
01061;Steinburg;131347;Schleswig-Holstein;124,415796;22,75118579;0;39381;11550;51163;23339;-11789;34889;90544;0,385326471;59816;455,4043869;79,77;19;32
01062;Stormarn;243196;Schleswig-Holstein;317,3970922;23,12538035;0;86534;49647;95504;58640;-8993;108287;182038;0,594859315;206258;848,1142782;81,91;21;15
02000;Hamburg;1841179;Hamburg;2438,357017;18,26302603;0;996031;359520;768571;132332;227188;491852;1764602;0,278732541;7096482;3854,314002;80,93;20;30
03101;Braunschweig;248292;Niedersachsen;1288,489881;21,01034266;0;132230;66069;102797;36715;29354;102784;235027;0,437328477;422747;1702,620302;80,48;17;31
03102;Salzgitter;104948;Niedersachsen;467,4952114;22,76556009;0;48611;25372;39019;15819;9553;41191;87630;0,470055917;52451;499,7808438;78,99;13;14
03103;Wolfsburg;124151;Niedersachsen;606,7689751;22,21085613;0;121298;78664;52446;9872;68792;88536;173744;0,509577309;367432;2959,557313;80,99;17;29
03151;Gifhorn;175920;Niedersachsen;112,2332451;20,04547522;0;43023;14819;72630;44446;-29627;59265;115653;0,512438069;130514;741,8940427;81,11;14;15
03153;Goslar;137014;Niedersachsen;141,729335;27,31034785;0;45617;12794;48916;16200;-3406;28994;94533;0,306707711;811258;5920,986177;79,79;10;9
03154;Helmstedt;91307;Niedersachsen;135,045554;23,38374933;0;23129;10184;37385;24462;-14278;34646;60514;0,572528671;97320;1065,854754;78,94;17;29
03155;Northeim;132765;Niedersachsen;104,6415398;25,36436561;0;45685;13838;51307;19483;-5645;33321;96992;0,343543797;157702;1187,828117;80,29;11;7
03157;Peine;133965;Niedersachsen;249,7017707;21,37871832;0;33030;11447;54179;32617;-21170;44064;87209;0,505268952;58422;436,0989811;80,18;13;12
03158;Wolfenb++ttel;119960;Niedersachsen;165,6265533;23,65871957;0;25091;10635;46957;32534;-21899;43169;72048;0,599169998;50681;422,4824942;80,28;13;14
03159;G+Âttingen;328074;Niedersachsen;186,8952199;22,64347122;0;130373;37075;122055;28805;8270;65880;252428;0,260985311;761436;2320,927596;81,14;12;13
03241;Region Hannover;1157624;Niedersachsen;503,9436166;21,07195428;0;517160;129166;452982;65199;63967;194365;970142;0,20034696;2215112;1913,498684;80,92;14;36
03251;Diepholz;216886;Niedersachsen;108,9337465;22,35321782;0;71721;24711;89700;42728;-18017;67439;161421;0,417783312;142714;658,0138875;80,53;15;22
03252;Hameln-Pyrmont;148559;Niedersachsen;186,2738706;25,37173783;0;52107;14193;56509;18607;-4414;32800;108616;0,301981292;306577;2063,671673;79,58;13;36
03254;Hildesheim;276594;Niedersachsen;228,902222;23,32190865;0;92812;23140;105638;35987;-12847;59127;198450;0,297944067;276748;1000,556773;79,95;17;34
03255;Holzminden;70975;Niedersachsen;102,2296801;26,28531173;0;22858;7931;25920;11001;-3070;18932;48778;0,388125794;107102;1509,010215;79,58;11;7
03256;Nienburg (Weser);121386;Niedersachsen;86,6535315;22,20190137;0;40796;11205;48217;18652;-7447;29857;89013;0,335422916;125934;1037,467253;79,91;15;11
03257;Schaumburg;157781;Niedersachsen;233,5212977;24,48140144;0;45718;14500;59725;28525;-14025;43025;105443;0,408040363;243549;1543,588899;80,07;13;12
03351;Celle;178936;Niedersachsen;115,3815401;23,35583672;0;58172;13014;66821;21677;-8663;34691;124993;0,277543542;304550;1702,005186;80,09;15;11
03352;Cuxhaven;198213;Niedersachsen;96,26850449;25,27533512;0;49164;10614;73462;34928;-24314;45542;122626;0,371389428;649721;3277,892974;79,97;20;33
03353;Harburg;252776;Niedersachsen;202,4718651;22,31738773;0;66534;27389;103720;64612;-37223;92001;170254;0,540374969;309301;1223,616957;81,51;18;13
03354;L++chow-Dannenberg;48424;Niedersachsen;39,45925244;27,78787378;0;14409;3622;16270;5486;-1864;9108;30679;0,296880602;96382;1990,376673;79,18;13;10
03355;L++neburg;183372;Niedersachsen;138,1010837;20,05595184;0;59494;16367;69882;26786;-10419;43153;129376;0,33354718;299961;1635,805903;80,29;15;15
03356;Osterholz;113517;Niedersachsen;173,9270995;23,39561475;0;27056;11107;44884;28945;-17838;40052;71940;0,556741729;63334;557,9252447;80,51;18;20
03357;Rotenburg (W++mme);163455;Niedersachsen;78,78184675;21,13242177;0;56980;14232;67875;25153;-10921;39385;124855;0,315445917;212110;1297,666024;80,28;18;20
03358;Heidekreis;139755;Niedersachsen;74,28008036;22,41565597;0;48041;10997;54440;17426;-6429;28423;102481;0,277348972;928181;6641,486888;80,43;15;11
03359;Stade;203102;Niedersachsen;160,2509074;21,40747014;0;63256;14709;82777;34259;-19550;48968;146033;0,335321468;212205;1044,819844;80,59;14;12
03360;Uelzen;92572;Niedersachsen;63,29276631;25,27978222;0;30026;7222;34147;11351;-4129;18573;64173;0,289420784;161682;1746,554034;79,31;13;7
03361;Verden;136792;Niedersachsen;173,299212;22,29150828;0;48260;20307;54763;26837;-6530;47144;103023;0,457606554;186049;1360,086847;81,03;18;20
03401;Delmenhorst;77607;Niedersachsen;1242,706165;21,94003118;0;20444;11060;26125;16757;-5697;27817;46569;0,597328695;32385;417,2948317;80,23;18;14
03402;Emden;50195;Niedersachsen;446,8132455;21,21127602;0;33262;19824;18273;4842;14982;24666;51535;0,478626176;93992;1872,537105;78,07;16;15
03403;Oldenburg (Oldb);168210;Niedersachsen;1631,681055;18,96974021;0;84385;42782;65434;23860;18922;66642;149819;0,444816746;168768;1003,317282;80,8;18;39
03404;Osnabr++ck;164748;Niedersachsen;1375,191987;18,58960352;0;96666;56561;66112;26031;30530;82592;162778;0,507390434;308896;1874,960546;80,87;20;44
03405;Wilhelmshaven;76278;Niedersachsen;712,4124405;26,06256063;0;30534;13013;25770;8258;4755;21271;56304;0,377788434;135239;1772,97517;78,99;15;11
03451;Ammerland;124071;Niedersachsen;169,8113982;23,1157966;0;44242;19595;48941;24310;-4715;43905;93183;0,471169634;281670;2270,232367;81,28;18;39
03452;Aurich;189848;Niedersachsen;147,473084;22,80192575;0;61152;14706;70690;24267;-9561;38973;131842;0,295603829;866388;4563,587712;79,1;16;15
03453;Cloppenburg;169348;Niedersachsen;119,2297673;16,37043248;0;67620;19204;72022;23662;-4458;42866;139642;0,306970682;167839;991,0893545;80,32;16;13
03454;Emsland;325657;Niedersachsen;112,9326129;18,94692882;0;140698;35474;134437;29311;6163;64785;275135;0,235466226;700295;2150,406716;80,21;15;14
03455;Friesland;98460;Niedersachsen;161,5316468;26,12126752;0;29458;10573;36374;17497;-6924;28070;65832;0,426388383;423577;4302,021125;80,46;15;11
03456;Grafschaft Bentheim;136511;Niedersachsen;139,0401401;20,54925977;0;50711;10670;53697;13680;-3010;24350;104408;0,233219677;240450;1761,396517;81,13;15;14
03457;Leer;169809;Niedersachsen;156,4050843;21,31689133;0;48168;12064;62556;26472;-14408;38536;110724;0,348036559;359336;2116,118698;79,48;16;15
03458;Oldenburg;130144;Niedersachsen;122,2204483;21,26874846;0;37041;16293;55820;35092;-18799;51385;92861;0,553353938;176548;1356,558889;80,63;18;39
03459;Osnabr++ck;357343;Niedersachsen;168,415025;20,67789211;0;130773;45856;152640;67829;-21973;113685;283413;0,401128389;458319;1282,574445;81,23;20;44
03460;Vechta;141598;Niedersachsen;173,9105871;16,1351149;0;72826;22713;64651;14606;8107;37319;137477;0,271456316;147496;1041,653131;81,75;16;13
03461;Wesermarsch;88624;Niedersachsen;107,4542897;23,46655533;0;30481;8645;34751;12932;-4287;21577;65232;0,33077324;202816;2288,499729;79,64;16;17
03462;Wittmund;56882;Niedersachsen;86,59947628;24,48577757;0;16448;5611;20752;9921;-4310;15532;37200;0,417526882;523251;9198,885412;79,73;15;11
04011;Bremen;569352;Bremen;1791,372746;20,94591746;0;281384;118623;208919;46268;72355;164891;490303;0,336304285;1165519;2047,097402;80,29;18;20
04012;Bremerhaven;113634;Bremen;1119,215995;21,75317247;0;52883;24053;40837;12023;12030;36076;93720;0,384933845;245393;2159,503318;77,7;17;20
05111;D++sseldorf;619294;Nordrhein-Westfalen;2848,507428;19,31538171;0;424470;261388;251511;88636;172752;350024;675981;0,517801536;3068803;4955,324935;80,89;23;44
05112;Duisburg;498590;Nordrhein-Westfalen;2141,709622;20,38227802;0;175307;86678;174739;86190;488;172868;350046;0,493843666;286066;573,7499749;79,04;19;38
05113;Essen;583109;Nordrhein-Westfalen;2772,221166;21,57624046;0;250602;129689;206496;85671;44018;215360;457098;0,471146231;814428;1396,699416;79,45;16;40
05114;Krefeld;227020;Nordrhein-Westfalen;1647,818828;21,90643996;0;94415;51443;83232;40345;11098;91788;177647;0,516687588;150590;663,333627;80;14;34
05116;M+Ânchengladbach;261454;Nordrhein-Westfalen;1533,724409;20,85376395;0;100119;45183;96787;41910;3273;87093;196906;0,442307497;193339;739,4761602;79,48;17;21
05117;M++lheim an der Ruhr;170880;Nordrhein-Westfalen;1872,042068;23,85475187;0;59416;35644;60402;36651;-1007;72295;119818;0,60337345;103254;604,2485955;80,26;16;37
05119;Oberhausen;210829;Nordrhein-Westfalen;2734,842392;21,82906526;0;66327;37455;75238;46398;-8943;83853;141565;0,592328612;234032;1110,056017;78,86;22;41
05120;Remscheid;110994;Nordrhein-Westfalen;1489,452496;22,16966683;0;46033;21560;42333;17877;3683;39437;88366;0,44629156;68415;616,3846694;79,63;19;31
05122;Solingen;159360;Nordrhein-Westfalen;1779,763234;21,30082831;0;53934;19984;62470;28559;-8575;48543;116404;0,417021752;53171;333,6533635;80,17;19;34
05124;Wuppertal;354382;Nordrhein-Westfalen;2104,531148;20,80241096;0;126634;49885;127846;51156;-1271;101041;254480;0,397048884;241456;681,3438606;80;19;43
05154;Kleve;310974;Nordrhein-Westfalen;252,2112913;20,66860895;0;102703;21991;115599;34949;-12958;56940;218302;0,260831325;438111;1408,834822;80,32;16;33
05158;Mettmann;485684;Nordrhein-Westfalen;1192,711377;23,81157296;0;193356;105401;187441;99582;5819;204983;380797;0,538299934;546079;1124,350401;81,04;14;44
05162;Rhein-Kreis Neuss;451007;Nordrhein-Westfalen;782,6178247;21,92671067;0;150159;69252;176969;96144;-26892;165396;327128;0,505600254;426468;945,5906449;81,14;21;36
05166;Viersen;298935;Nordrhein-Westfalen;530,7135122;22,106478;0;94050;39096;112473;57564;-18468;96660;206523;0,468035037;173549;580,5576463;80,61;17;19
05170;Wesel;459809;Nordrhein-Westfalen;440,9326723;23,26509485;0;138260;53359;169489;84651;-31292;138010;307749;0,448449873;433371;942,5022129;80,64;16;19
05314;Bonn;327258;Nordrhein-Westfalen;2319,991493;18,00811592;0;180528;105487;119965;45000;60487;150487;300493;0,500800351;853501;2608,037084;82,23;15;40
05315;K+Âln;1085664;Nordrhein-Westfalen;2680,585665;17,35067203;0;582613;284207;426259;128138;156069;412345;1008872;0,408718846;3699735;3407,808493;80,7;18;43
05316;Leverkusen;163838;Nordrhein-Westfalen;2077,317104;21,67140712;0;65077;37124;63556;35630;1494;72754;128633;0,565593588;132591;809,2811192;81,13;13;38
05334;St+ñdteregion Aachen;555465;Nordrhein-Westfalen;785,7536921;20,26878381;0;219517;52956;206745;40310;12646;93266;426262;0,218799705;801514;1442,960403;80,88;15;10
05358;D++ren;263722;Nordrhein-Westfalen;280,1113129;21,24775332;0;85767;28759;100280;43324;-14565;72083;186047;0,387445108;222439;843,4601588;80;21;40
05362;Rhein-Erft-Kreis;470089;Nordrhein-Westfalen;667,0767703;21,33042892;0;145370;66708;184783;106224;-39516;172932;330153;0,523793514;514725;1094,952232;80,91;18;40
05366;Euskirchen;192840;Nordrhein-Westfalen;154,4301365;21,61014312;0;57908;14926;73623;30667;-15741;45593;131531;0,346633113;293531;1522,147895;79,95;8,6;5
05370;Heinsberg;254322;Nordrhein-Westfalen;405,0229329;20,8452277;0;73665;19341;94432;40145;-20804;59486;168097;0,35387901;110024;432,6169187;80,42;18;16
05374;Oberbergischer Kreis;272471;Nordrhein-Westfalen;296,5380262;21,27455766;0;105880;31261;109632;35051;-3790;66312;215512;0,307695163;283826;1041,67416;80,28;19;39
05378;Rheinisch-Bergischer Kreis;283455;Nordrhein-Westfalen;648,163816;23,14476725;0;75444;35551;107895;68032;-32481;103583;183339;0,564980719;232111;818,8636644;81,81;13;33
05382;Rhein-Sieg-Kreis;599780;Nordrhein-Westfalen;520,0960796;21,3398246;0;163453;61543;228702;126885;-65342;188428;392155;0,480493682;617803;1030,049351;81,65;15;40
05512;Bottrop;117383;Nordrhein-Westfalen;1166,71305;22,34054335;0;33557;18910;41890;27256;-8346;46166;75447;0,611899744;38733;329,9711202;79,63;20;32
05513;Gelsenkirchen;260654;Nordrhein-Westfalen;2483,838384;20,6116154;0;81580;44899;85053;48397;-3498;93296;166633;0,559889098;143948;552,257015;78,49;26;41
05515;M++nster;314319;Nordrhein-Westfalen;1036,398707;17,09982534;0;172362;84296;119802;31792;52504;116088;292164;0,397338481;658531;2095,104019;82,43;20;33
05554;Borken;370676;Nordrhein-Westfalen;260,8649143;18,93567428;0;148928;30553;152789;34464;-3911;65017;301717;0,215490012;339147;914,94189;80,88;17;17
05558;Coesfeld;219929;Nordrhein-Westfalen;197,7707636;20,72714376;0;70528;24702;90725;44934;-20232;69636;161253;0,431843128;209091;950,7204598;81,4;16;16
05562;Recklinghausen;615261;Nordrhein-Westfalen;808,1503179;22,78837762;0;171583;58435;223290;110220;-51785;168655;394873;0,427112008;359521;584,3390041;79,97;19;35
05566;Steinfurt;447614;Nordrhein-Westfalen;249,261594;19,78468055;0;161800;38940;186575;63756;-24816;102696;348375;0,294785791;360103;804,4944975;81,37;20;33
05570;Warendorf;277783;Nordrhein-Westfalen;210,5341741;21,08624358;0;93628;25941;114728;47069;-21128;73010;208356;0,350409875;176409;635,0604609;81,73;16;33
05711;Bielefeld;333786;Nordrhein-Westfalen;1289,595487;19,88669387;0;158107;69551;128488;40005;29546;109556;286595;0,38226766;376401;1127,671622;81,04;20;29
05754;G++tersloh;364083;Nordrhein-Westfalen;375,6492401;19,51011171;0;182430;70093;159125;46939;23154;117032;341555;0,342644669;277106;761,1066707;81,7;20;31
05758;Herford;250783;Nordrhein-Westfalen;556,7882596;22,10317286;0;95296;34994;102157;41891;-6897;76885;197453;0,389383803;99293;395,9319412;81,17;16;21
05762;H+Âxter;140667;Nordrhein-Westfalen;117,0839507;22,63288476;0;45324;11189;55299;21171;-9982;32360;100623;0,321596454;243583;1731,628598;80,54;11;7
05766;Lippe;348391;Nordrhein-Westfalen;279,5649139;22,45982244;0;115183;27618;135714;48184;-20566;75802;250897;0,302123979;435237;1249,277392;80,85;13;12
05770;Minden-L++bbecke;310710;Nordrhein-Westfalen;269,6152444;21,98223424;0;129295;39115;126062;35936;3179;75051;255357;0,293906178;315005;1013,823179;80,96;13;12
05774;Paderborn;306890;Nordrhein-Westfalen;246,1460723;18,00417088;0;120203;30069;123916;33771;-3702;63840;244119;0,261511804;359273;1170,689824;81,47;12;40
05911;Bochum;364628;Nordrhein-Westfalen;2503,281615;22,07811797;0;136377;69132;132087;64885;4247;134017;268464;0,499199148;370633;1016,468839;79,88;13;38
05913;Dortmund;587010;Nordrhein-Westfalen;2091,161697;20,47818606;0;246603;112835;215842;82189;30646;195024;462445;0,421723664;814607;1387,722526;79,3;18;37
05914;Hagen;188814;Nordrhein-Westfalen;1176,777812;22,23616893;0;71165;31902;69601;30355;1547;62257;140766;0,442272992;114643;607,1742561;78,97;24;44
05915;Hamm;179111;Nordrhein-Westfalen;791,0215078;20,84740747;0;60428;22614;65365;27585;-4971;50199;125793;0,399060361;110962;619,5152727;79,65;12;33
05916;Herne;156374;Nordrhein-Westfalen;3041,112408;21,84058731;0;46007;26525;53658;34194;-7669;60719;99665;0,609230924;37083;237,1430033;78,62;17;38
05954;Ennepe-Ruhr-Kreis;324296;Nordrhein-Westfalen;791,699624;23,66418334;0;109992;48773;124466;63288;-14515;112061;234458;0,477957673;205501;633,683425;79,98;17;45
05958;Hochsauerlandkreis;260475;Nordrhein-Westfalen;132,8852384;22,01017372;0;107282;22540;108195;23490;-950;46030;215477;0,213619087;1282432;4923,43603;80,42;18;9
05962;M+ñrkischer Kreis;412120;Nordrhein-Westfalen;388,4040488;22,0316898;0;163576;36339;164496;37325;-986;73664;328072;0,224536077;209005;507,1459769;79,97;24;44
05966;Olpe;134775;Nordrhein-Westfalen;189,2535176;20,13503988;0;60159;16738;57829;14428;2310;31166;117988;0,264145506;265926;1973,11074;80,55;9,8;3
05970;Siegen-Wittgenstein;278210;Nordrhein-Westfalen;245,5754751;21,48484957;0;117968;29024;112570;23669;5355;52693;230538;0,228565356;255728;919,1905395;80,37;9,8;3
05974;Soest;301902;Nordrhein-Westfalen;227,2280469;21,2168187;0;112583;28636;121322;37407;-8771;66043;233905;0,282349672;434833;1440,311757;80,06;14;9
05978;Unna;394782;Nordrhein-Westfalen;726,7576076;22,74774432;0;133128;58712;149469;75140;-16428;133852;282597;0,473649756;214991;544,5815665;79,97;12;20
06411;Darmstadt;159207;Hessen;1304,227083;17,22034835;0;105338;72603;63820;31121;41482;103724;169158;0,613178212;353372;2219,575772;80,79;14;22
06412;Frankfurt am Main;753056;Hessen;3032,725223;15,63761526;0;602428;387518;315445;100930;286588;488448;917873;0,532152052;5934778;7880,92519;81,58;22;29
06413;Offenbach am Main;128744;Hessen;2868,627451;16,45591251;0;48230;33098;55081;39951;-6853;73049;103311;0,707078627;254560;1977,257193;80,85;22;45
06414;Wiesbaden;278342;Hessen;1365,291607;19,976863;0;137731;77721;110038;50092;27629;127813;247769;0,515855494;580346;2085,010527;81,37;16;44
06431;Bergstra+e;269694;Hessen;374,8457219;22,19700846;0;76359;28725;107106;59515;-30790;88240;183465;0,480963672;335379;1243,553805;80,62;16;30
06432;Darmstadt-Dieburg;297399;Hessen;451,5555488;20,74922915;0;77339;35536;120789;79035;-43499;114571;198128;0,578267585;240212;807,7095081;81,72;14;22
06433;Gro+-Gerau;274526;Hessen;605,9775291;19,22513715;0;101095;55098;114559;68625;-13527;123723;215654;0,573710666;676968;2465,952223;80,95;15;16
06434;Hochtaunuskreis;236564;Hessen;490,9596547;22,58078152;0;97597;58121;88751;49330;8791;107451;186348;0,576614721;485210;2051,07286;82,76;8,4;6
06435;Main-Kinzig-Kreis;418950;Hessen;299,821803;21,52834467;0;138660;47646;168222;77266;-29620;124912;306882;0,407035929;385410;919,9427139;81,29;16;6
06436;Main-Taunus-Kreis;237735;Hessen;1068,375876;21,15885335;0;102385;70212;97661;65535;4677;135747;200046;0,678578927;438865;1846,026037;82,4;19;34
06437;Odenwaldkreis;96798;Hessen;155,127486;23,57796649;0;27659;6291;37482;16130;-9839;22421;65141;0,34419183;152492;1575,363127;80,64;15;16
06438;Offenbach;354092;Hessen;993,9982596;21,18573704;0;128577;72035;143481;87026;-14991;159061;272058;0,584658418;497704;1405,578211;82,19;22;45
06439;Rheingau-Taunus-Kreis;187157;Hessen;230,6536689;22,85086852;0;45613;18709;71676;44798;-26089;63507;117289;0,541457426;507384;2711,007336;81,72;16;44
06440;Wetteraukreis;306460;Hessen;278,4253514;21,12119037;0;87057;32702;122537;68217;-35515;100919;209594;0,481497562;252039;822,4205443;81,12;16;24
06531;Gie+en;268876;Hessen;314,6367721;19,35910978;0;99254;34182;100286;35258;-1076;69440;199540;0,348000401;249431;927,6804177;81,27;17;15
06532;Lahn-Dill-Kreis;253777;Hessen;237,9977492;22,08474369;0;95693;26458;99005;29812;-3354;56270;194698;0,2890117;253830;1000,208845;80,79;18;20
06533;Limburg-Weilburg;172083;Hessen;233,0390152;21,44895196;0;54921;19709;65636;30456;-10747;50165;120557;0,416110222;223659;1299,715835;80,22;21;46
06534;Marburg-Biedenkopf;246648;Hessen;195,3848713;19,63810775;0;92742;21068;95315;23677;-2609;44745;188057;0,23793318;284845;1154,864422;81,08;16;36
06535;Vogelsbergkreis;105878;Hessen;72,57385702;24,32233325;0;32499;8765;41837;18118;-9353;26883;74336;0,361641735;215986;2039,951642;80,31;15;42
06611;Kassel;201585;Hessen;1887,5;19,48904928;0;112850;64944;74527;26699;38245;91643;187377;0,489083505;533093;2644,50728;80,35;16;20
06631;Fulda;222584;Hessen;161,2436795;21,06845056;0;94241;21997;89702;17514;4483;39511;183943;0,214800237;803195;3608,502857;81,73;19;38
06632;Hersfeld-Rotenburg;120829;Hessen;110,069688;23,97023893;0;49147;14759;46877;13314;1445;28073;96024;0,292353995;383617;3174,875237;80,33;16;14
06633;Kassel;236633;Hessen;182,961302;24,84776003;0;74877;34808;92092;52061;-17253;86869;166969;0,52027023;306125;1293,669945;80,85;11;7
06634;Schwalm-Eder-Kreis;180222;Hessen;117,1033138;23,25354285;0;56087;15721;72195;31857;-16136;47578;128282;0,370886017;236011;1309,557102;80,04;11;6
06635;Waldeck-Frankenberg;156953;Hessen;84,8991183;23,13176556;0;63889;14451;64637;15218;-767;29669;128526;0,230840453;851662;5426,223137;80,58;11;6
06636;Werra-Mei+ner-Kreis;101017;Hessen;98,56855704;25,56797371;0;28596;6846;36843;15134;-8288;21980;65439;0,335885328;170899;1691,784551;79,75;10;6
07111;Koblenz;114024;Rheinland-Pfalz;1083,36342;21,60422367;0;75454;50248;41912;16735;33513;66983;117366;0,570718948;360612;3162,597348;80,7;18;31
07131;Ahrweiler;129727;Rheinland-Pfalz;164,8289795;24,51687004;0;34995;10465;48965;24453;-13988;34918;83960;0,415888518;539460;4158,425;81,51;19;40
07132;Altenkirchen (Westerwald);128705;Rheinland-Pfalz;200,3564868;22,29439416;0;38977;12944;50748;24730;-11786;37674;89725;0,419882976;91848;713,631949;80,14;9,4;6
07133;Bad Kreuznach;158080;Rheinland-Pfalz;182,9862598;23,26417004;0;53188;16390;60908;24122;-7732;40512;114096;0,355069415;255544;1616,548583;80,29;8,5;22
07134;Birkenfeld;80720;Rheinland-Pfalz;103,9108159;24,26288404;0;27584;6918;30587;9929;-3011;16847;58171;0,289611662;98007;1214,160059;79,21;8,5;5
07135;Cochem-Zell;61587;Rheinland-Pfalz;88,93814895;24,32331499;0;19726;6326;23854;10466;-4140;16792;43580;0,385314364;522774;8488,382288;79,9;19;21
07137;Mayen-Koblenz;214259;Rheinland-Pfalz;262,02962;21,91179834;0;69065;28800;83445;43213;-14413;72013;152510;0,47218543;350121;1634,101718;81,09;19;25
07138;Neuwied;181941;Rheinland-Pfalz;290,1585226;22,27315448;0;63263;25742;71186;33711;-7969;59453;134449;0,442197413;156291;859,0202318;80,37;19;25
07140;Rhein-Hunsr++ck-Kreis;102937;Rheinland-Pfalz;103,8645101;22,73137939;0;38965;11163;42272;14483;-3320;25646;81237;0,315693588;364093;3537,046932;80,75;18;22
07141;Rhein-Lahn-Kreis;122308;Rheinland-Pfalz;156,3661003;23,41302286;0;32478;11517;47100;26154;-14637;37671;79578;0,473384604;246422;2014,766001;80,1;16;7
07143;Westerwaldkreis;201597;Rheinland-Pfalz;203,8268659;21,09753617;0;69806;21444;81787;33466;-12022;54910;151593;0,362219891;306906;1522,373845;80,47;21;7
07211;Trier;110636;Rheinland-Pfalz;945,1221596;17,74467624;0;56007;30386;35697;10103;20283;40489;91704;0,441518363;461377;4170,224882;80,32;16;27
07231;Bernkastel-Wittlich;112262;Rheinland-Pfalz;96,1221327;22,7788566;0;41113;10785;43953;13643;-2858;24428;85066;0,28716526;516671;4602,367676;81,07;8,5;16
07232;Eifelkreis Bitburg-Pr++m;98561;Rheinland-Pfalz;60,58059916;20,68566674;0;28647;6921;30793;9083;-2162;16004;59440;0,269246299;231140;2345,14666;80,06;8,9;4
07233;Vulkaneifel;60603;Rheinland-Pfalz;66,47616958;24,19187169;0;20056;6223;23136;9308;-3085;15531;43192;0,359580478;390504;6443,641404;80,75;8,9;4
07235;Trier-Saarburg;148945;Rheinland-Pfalz;135,1318249;20,65796099;0;31068;12001;45905;26848;-14847;38849;76973;0,504709444;330258;2217,315116;81,42;16;27
07311;Frankenthal (Pfalz);48561;Rheinland-Pfalz;1106,677302;22,79813019;0;18430;13374;16090;11042;2332;24416;34520;0,707300116;52783;1086,942196;80,18;18;28
07312;Kaiserslautern;99845;Rheinland-Pfalz;714,7100931;20,30447193;0;54197;31268;36809;13897;17371;45165;91006;0,496285959;110854;1110,260904;79,51;15;19
07313;Landau in der Pfalz;46677;Rheinland-Pfalz;562,7803231;19,18075283;0;23807;16461;17523;10195;6266;26656;41330;0,644955238;56011;1199,970007;80,4;8,1;5
07314;Ludwigshafen am Rhein;171061;Rheinland-Pfalz;2209,234147;18,83947831;0;104883;72300;67758;35225;37075;107525;172641;0,622824242;127893;747,6455767;80,36;21;38
07315;Mainz;217118;Rheinland-Pfalz;2221,61056;17,51582089;0;114810;70677;87270;43189;27488;113866;202080;0,563469913;600073;2763,810463;81,84;19;30
07316;Neustadt an der Weinstra+e;53148;Rheinland-Pfalz;453,9072508;24,35463235;0;17557;9964;20195;12606;-2642;22570;37752;0,597849121;102819;1934,578912;80,84;21;28
07317;Pirmasens;40403;Rheinland-Pfalz;658,458279;25,46345568;0;20690;11983;14293;5593;6390;17576;34983;0,502415459;27856;689,4537534;77,35;14;14
07318;Speyer;50378;Rheinland-Pfalz;1179,536408;22,65671523;0;29309;20392;19457;10551;9841;30943;48766;0,634519952;155565;3087,95506;80,03;21;28
07319;Worms;83330;Rheinland-Pfalz;766,3938196;20,48841954;0;34080;17558;33865;17374;184;34932;67945;0,514121716;74586;895,0678027;80,13;20;26
07320;Zweibr++cken;34209;Rheinland-Pfalz;484,2723669;23,14010933;0;15386;9517;13182;7322;2195;16839;28568;0,589435732;26993;789,0613581;79,59;14;14
07331;Alzey-Worms;129244;Rheinland-Pfalz;219,77282;20,04580483;0;30091;12814;53123;35867;-23053;48681;83214;0,585009734;87612;677,8805979;80,89;20;26
07332;Bad D++rkheim;132660;Rheinland-Pfalz;223,1042196;24,16327454;0;32431;14000;52526;34115;-20115;48115;84957;0,566345328;343453;2588,971808;80,91;18;28
07333;Donnersbergkreis;75101;Rheinland-Pfalz;116,3598897;21,75337213;0;22160;8385;30269;16500;-8115;24885;52429;0,474641897;68890;917,2980386;79,39;15;19
07334;Germersheim;129075;Rheinland-Pfalz;278,5871536;19,84505133;0;46072;22009;54956;30919;-8910;52928;101028;0,523894366;61655;477,6680225;81,18;16;17
07335;Kaiserslautern;106057;Rheinland-Pfalz;165,7192412;21,59687715;0;25677;12239;40381;26951;-14712;39190;66058;0,593266523;90535;853,6447382;80,75;15;19
07336;Kusel;70526;Rheinland-Pfalz;122,9575648;23,9486147;0;12478;3875;26899;18298;-14423;22173;39377;0,563095208;37888;537,2203159;79,45;11;6
07337;S++dliche Weinstra+e;110356;Rheinland-Pfalz;172,4447222;23,18496502;0;31611;15441;43714;27570;-12129;43011;75325;0,571005642;315227;2856,455471;81,57;8,1;5
07338;Rhein-Pfalz-Kreis;154201;Rheinland-Pfalz;505,5604734;22,67884125;0;28555;15684;64248;51388;-35704;67072;92803;0,722735256;73646;477,5974215;81,96;21;28
07339;Mainz-Bingen;210889;Rheinland-Pfalz;348,3638106;20,68671197;0;57507;27713;85888;56113;-28400;83826;143395;0,584581052;237751;1127,375065;81,79;16;21
07340;S++dwestpfalz;95113;Rheinland-Pfalz;99,7420275;25,12274873;0;15214;5089;37117;26991;-21902;32080;52331;0,613020963;137341;1443,977164;81,33;14;14
08111;Stuttgart;634830;Baden-W++rttemberg;3061,930256;17,84714018;0;426014;257924;265214;97310;160614;355234;691228;0,51391726;2062673;3249,173795;82,43;20;50
08115;B+Âblingen;391640;Baden-W++rttemberg;633,9473599;19,86824635;0;184122;85429;170047;71434;13995;156863;354169;0,442904376;499294;1274,879992;82,89;13;12
08116;Esslingen;533859;Baden-W++rttemberg;832,4897081;20,43985397;0;220226;86275;230140;96300;-10025;182575;450366;0,405392503;819398;1534,858455;82,71;16;24
08117;G+Âppingen;257253;Baden-W++rttemberg;400,5059783;21,56009842;0;89146;21457;105512;37878;-16421;59335;194658;0,304816653;230854;897,3811773;81,83;23;34
08118;Ludwigsburg;543984;Baden-W++rttemberg;792,1020444;19,77447866;0;207813;76659;236187;105167;-28508;181826;444000;0,409518018;515486;947,6124298;82,57;24;33
08119;Rems-Murr-Kreis;426158;Baden-W++rttemberg;496,635551;21,03374805;0;153295;48717;180642;76142;-27425;124859;333937;0,373899867;350663;822,8473946;82,24;23;39
08121;Heilbronn;125960;Baden-W++rttemberg;1260,987086;19,46093998;0;71840;44956;54503;27664;17292;72620;126343;0,574784515;174884;1388,409019;80,66;22;47
08125;Heilbronn;343068;Baden-W++rttemberg;311,8970126;19,20989425;0;146031;59187;153116;66346;-7159;125533;299147;0,4196365;407824;1188,755582;81,56;18;24
08126;Hohenlohekreis;112010;Baden-W++rttemberg;144,2015552;19,45183466;0;59414;22483;51720;14813;7670;37296;111134;0,335594867;208595;1862,289081;81,32;18;24
08127;Schw+ñbisch Hall;195861;Baden-W++rttemberg;131,97647;19,21260486;0;84410;17851;86694;20175;-2324;38026;171104;0,222239106;277719;1417,939253;81,72;14;21
08128;Main-Tauber-Kreis;132321;Baden-W++rttemberg;101,4638223;22,53308243;0;56792;17607;56672;17505;102;35112;113464;0,309454981;358976;2712,917829;81,43;13;13
08135;Heidenheim;132472;Baden-W++rttemberg;211,2420468;21,83480283;0;53330;15109;55532;17328;-2219;32437;108862;0,297964395;126029;951,363307;81,56;14;36
08136;Ostalbkreis;314002;Baden-W++rttemberg;207,7584724;20,57821288;0;128866;27119;131616;29939;-2820;57058;260482;0,219047765;394031;1254,867803;81,67;14;21
08211;Baden-Baden;55123;Baden-W++rttemberg;393,2020829;26,10525552;0;30704;20510;21487;11303;9207;31813;52191;0,609549539;452982;8217,658691;80,26;12;14
08212;Karlsruhe;313092;Baden-W++rttemberg;1805,397301;18,3811787;0;178857;102552;124229;48010;54542;150562;303086;0,496763295;658668;2103,752252;81,81;16;34
08215;Karlsruhe;444232;Baden-W++rttemberg;409,3247825;21,10068613;0;158434;63297;188071;93022;-29725;156319;346505;0,451130575;401617;904,0703956;81,94;17;34
08216;Rastatt;231018;Baden-W++rttemberg;312,8459997;21,57494221;0;94741;33995;101217;40517;-6522;74512;195958;0,380244746;289301;1252,287701;81,72;12;14
08221;Heidelberg;160355;Baden-W++rttemberg;1473,444822;16,37055284;0;91782;62157;54282;24695;37462;86852;146064;0,594616059;794339;4953,627888;82,72;15;34
08222;Mannheim;309370;Baden-W++rttemberg;2134,02773;18,41451983;0;191615;115480;129112;53072;62408;168552;320727;0,525531059;673571;2177,23438;80,27;20;42
08225;Neckar-Odenwald-Kreis;143535;Baden-W++rttemberg;127,4790177;21,55920159;0;46597;9486;60451;23362;-13876;32848;107048;0,306853001;161690;1126,484829;80,84;15;16
08226;Rhein-Neckar-Kreis;547625;Baden-W++rttemberg;515,8778755;21,45921023;0;176587;72417;224480;120421;-48004;192838;401067;0,480812433;799161;1459,321616;81,85;15;34
08231;Pforzheim;125542;Baden-W++rttemberg;1281,171548;20,07535327;0;59006;31385;51482;23881;7504;55266;110488;0,500199117;120650;961,0329611;81,09;14;33
08235;Calw;158397;Baden-W++rttemberg;198,6617669;20,80847491;0;48307;14693;68486;34894;-20201;49587;116793;0,424571678;445259;2811,031775;82,12;13;37
08236;Enzkreis;198905;Baden-W++rttemberg;346,7539486;21,16437495;0;64050;29018;85081;50082;-21064;79100;149131;0,530406153;123976;623,2925266;82,48;14;33
08237;Freudenstadt;117935;Baden-W++rttemberg;135,4951746;20,53249671;0;48186;12605;52331;16770;-4165;29375;100517;0,292239124;520602;4414,312969;81,26;14;31
08311;Freiburg im Breisgau;230241;Baden-W++rttemberg;1504,449817;16,49489014;0;129151;69924;84827;25668;44256;95592;213978;0,446737515;881280;3827,641471;81,91;13;16
08315;Breisgau-Hochschwarzwald;262795;Baden-W++rttemberg;190,6618879;21,80368728;0;83875;29709;104898;50782;-21073;80491;188773;0,426390427;1412900;5376,434103;83,17;7,6;2
08316;Emmendingen;165383;Baden-W++rttemberg;243,2782689;20,91569266;0;53730;17202;70389;33888;-16686;51090;124119;0,411621106;276066;1669,252583;82,14;13;16
08317;Ortenaukreis;429479;Baden-W++rttemberg;230,8654518;20,81894575;0;185045;30940;186288;32287;-1347;63227;371333;0,17027035;1799732;4190,500583;81,73;16;24
08325;Rottweil;139455;Baden-W++rttemberg;181,2445577;21,04478147;0;57978;17521;60262;19830;-2309;37351;118240;0,315891407;133928;960,3671435;81,57;14;31
08326;Schwarzwald-Baar-Kreis;212381;Baden-W++rttemberg;207,1322683;22,18418785;0;89568;20819;89268;20558;261;41377;178836;0,231368405;482085;2269,906442;81,85;12;14
08327;Tuttlingen;140152;Baden-W++rttemberg;190,8491748;19,55947828;0;67708;19457;61665;13449;6008;32906;129373;0,254349826;140576;1003,025287;81,5;12;14
08335;Konstanz;285325;Baden-W++rttemberg;348,816597;20,84430036;0;103848;14407;107124;17745;-3338;32152;210972;0,152399371;949232;3326,844826;81,93;14;19
08336;L+Ârrach;228639;Baden-W++rttemberg;283,4180385;20,29487533;0;80062;14874;77456;12305;2569;27179;157518;0,17254536;536193;2345,15109;81,83;7,3;4
08337;Waldshut;170619;Baden-W++rttemberg;150,8380925;21,17407792;0;55530;8379;57084;9964;-1585;18343;112614;0,162883833;386153;2263,247352;81,75;7,6;2
08415;Reutlingen;286748;Baden-W++rttemberg;262,4791754;20,48802433;0;115970;33466;121861;39417;-5951;72883;237831;0,306448697;437271;1524,931299;82,69;9,9;6
08416;T++bingen;227331;Baden-W++rttemberg;437,9245247;17,23170179;0;83039;30723;90274;38010;-7287;68733;173313;0,396583061;216422;952,0127039;83,01;15;19
08417;Zollernalbkreis;188935;Baden-W++rttemberg;205,9102402;22,05308704;0;70125;13901;79823;23627;-9726;37528;149948;0,250273428;148339;785,132453;81,96;9,9;28
08421;Ulm;126329;Baden-W++rttemberg;1064,450624;18,3607881;0;95855;64008;53788;21996;42012;86004;149643;0,574727852;442326;3501,381314;82,01;15;24
08425;Alb-Donau-Kreis;196047;Baden-W++rttemberg;144,3071238;19,24028422;0;56222;20074;86385;50278;-30204;70352;142607;0,493327817;275874;1407,182971;82,11;15;24
08426;Biberach;199742;Baden-W++rttemberg;141,7122505;18,57295912;0;86785;24905;88984;27143;-2238;52048;175769;0,296115925;252688;1265,071943;81,62;14;16
08435;Bodenseekreis;216227;Baden-W++rttemberg;325,2560959;22,61465959;0;94904;25023;91767;21941;3082;46964;186671;0,251587017;1108528;5126,686307;82,73;14;21
08436;Ravensburg;284285;Baden-W++rttemberg;174,1846344;19,7801502;0;120794;32244;121002;32505;-261;64749;241796;0,267783586;479313;1686,029864;82,01;14;36
08437;Sigmaringen;130873;Baden-W++rttemberg;108,6786468;20,28837117;0;48507;12381;55147;19045;-6664;31426;103654;0,303181739;204441;1562,132755;81,24;9,9;6
09161;Ingolstadt;136981;Bayern;1027,229096;18,3514502;0;107531;65245;62977;20738;44507;85983;170508;0,504275459;332813;2429,628927;82,09;16;23
09162;M++nchen;1471508;Bayern;4736,105568;17,62069931;0;897140;403100;684488;191015;212085;594115;1581628;0,375635105;8265994;5617,362597;82,97;15;27
09163;Rosenheim;63324;Bayern;1701,343364;20,1061209;0;35596;23723;26413;14568;9155;38291;62009;0,617507136;143307;2263,075611;81,16;16;28
09171;Alt+Âtting;111210;Bayern;195,3485921;21,75883464;0;48373;17034;46583;15286;1748;32320;94956;0,340368171;131731;1184,524773;80,53;16;13
09172;Berchtesgadener Land;105722;Bayern;125,8805039;23,64692306;0;36842;7099;36988;7271;-172;14370;73830;0,194636327;772136;7303,456234;81,53;15;11
09173;Bad T+Âlz-Wolfratshausen;127227;Bayern;114,5508076;21,33587996;0;38329;10334;51971;24011;-13677;34345;90300;0,3803433;398474;3131,992423;81,97;11;7
09174;Dachau;153884;Bayern;265,706639;18,44896156;0;43707;19698;70014;46037;-26339;65735;113721;0,578037478;150965;981,0311663;82,07;24;21
09175;Ebersberg;142142;Bayern;258,7269517;18,68624333;0;41632;22659;62033;43094;-20435;65753;103665;0,634283509;211292;1486,485346;82,65;14;19
09176;Eichst+ñtt;132341;Bayern;109,0276233;17,5327374;0;41770;19818;57831;35908;-16090;55726;99601;0,559492375;458726;3466,24251;81,82;16;23
09177;Erding;137660;Bayern;158,0972288;16,90469272;0;46280;20954;63304;38013;-17059;58967;109584;0,538098628;878834;6384,091239;82,15;16;24
09178;Freising;179116;Bayern;223,9425878;15,76464414;0;84720;47569;84677;47594;-25;95163;169397;0,561775002;668169;3730,370263;81,96;14;19
09179;F++rstenfeldbruck;219320;Bayern;504,4042225;21,53839139;0;52422;22501;90979;61090;-38589;83591;143401;0,582917832;140558;640,8809046;82,7;11;21
09180;Garmisch-Partenkirchen;88467;Bayern;87,40330182;25,06358303;0;29426;5074;33658;9330;-4256;14404;63084;0,22833048;1192002;13473,97335;81,6;11;9
09181;Landsberg am Lech;120071;Bayern;149,2733444;19,95569288;0;39891;16252;48445;24826;-8574;41078;88336;0,465019924;121932;1015,499163;82,51;11;7
09182;Miesbach;99726;Bayern;115,1277966;22,61396226;0;36606;13081;40205;16704;-3623;29785;76811;0,387769981;751918;7539,839159;81,74;16;28
09183;M++hldorf a. Inn;115250;Bayern;143,107259;19,88806941;0;42067;12838;48922;19955;-7117;32793;90989;0,360406203;89035;772,537961;80,02;15;17
09184;M++nchen;348871;Bayern;525,202481;20,44365969;0;240769;189150;143829;92379;96771;281529;384598;0,732008487;1316342;3773,148241;83,02;19;42
09185;Neuburg-Schrobenhausen;96680;Bayern;130,698102;19,02358295;0;32997;11904;42854;21783;-9879;33687;75851;0,44412071;68572;709,2676872;81,32;16;23
09186;Pfaffenhofen a.d. Ilm;127151;Bayern;167,075318;18,15715173;0;43723;21001;57243;34562;-13561;55563;100966;0,550313967;155307;1221,437503;81,68;16;23
09187;Rosenheim;260983;Bayern;181,3074438;21,28606078;0;86061;26852;104312;45270;-18418;72122;190373;0,37884574;799895;3064,931432;81,54;16;28
09188;Starnberg;136092;Bayern;279,0371525;22,9080328;0;52419;32015;49908;29542;2473;61557;102327;0,601571433;300718;2209,66699;83,39;11;7
09189;Traunstein;177089;Bayern;115,4554286;22,66261597;0;69051;15725;71274;17987;-2262;33712;140325;0,240242295;762965;4308,370367;82,06;15;17
09190;Weilheim-Schongau;135348;Bayern;140,0712009;21,55850105;0;50216;15685;55595;21085;-5400;36770;105811;0,347506403;178499;1318,815202;81,88;11;7
09261;Landshut;72404;Bayern;1099,863284;20,44085962;0;38108;24493;30212;16624;7869;41117;68320;0,601829625;119580;1651,566212;80,44;16;24
09262;Passau;52469;Bayern;754,2984474;21,38024357;0;40177;27263;19220;6325;20938;33588;59397;0,565483105;331264;6313,518459;79,7;18;29
09263;Straubing;47794;Bayern;707,1164373;21,28300624;0;30327;18456;19876;8017;10439;26473;50203;0,527319085;83373;1744,423986;78,8;20;35
09271;Deggendorf;119326;Bayern;138,5658712;20,33002028;0;50905;16266;50593;15977;289;32243;101498;0,317671284;172345;1444,320601;79,76;18;3
09272;Freyung-Grafenau;78355;Bayern;79,63149283;21,65783932;0;26375;6016;32092;11743;-5727;17759;58467;0,303743992;320908;4095,565056;80,09;18;3
09273;Kelheim;122258;Bayern;114,7800779;18,568928;0;40237;11977;54054;25818;-13841;37795;94291;0,40083359;292810;2395,017095;80,98;16;9
09274;Landshut;158698;Bayern;117,7669269;18,60766991;0;51632;21856;69406;39680;-17824;61536;121038;0,50840232;115116;725,3777615;81,39;16;24
09275;Passau;192043;Bayern;125,5133786;22,00757122;0;62004;17087;77673;32802;-15715;49889;139677;0,357174052;843019;4389,740839;80,59;18;29
09276;Regen;77656;Bayern;79,66515521;22,24168126;0;29017;6889;31410;9304;-2415;16193;60427;0,267976236;508498;6548,083857;79,53;18;3
09277;Rottal-Inn;120659;Bayern;94,1772883;21,3287032;0;39709;9555;49065;18933;-9378;28488;88774;0,320904769;200631;1662,793492;80,36;16;13
09278;Straubing-Bogen;100649;Bayern;83,7610892;19,55508748;0;27384;10801;43568;27008;-16207;37809;70952;0,532881385;196569;1953,014933;81,37;20;35
09279;Dingolfing-Landau;96217;Bayern;109,6390073;19,0205473;0;50603;20938;44676;15046;5892;35984;95279;0,377669791;65927;685,1907667;80,36;16;24
09361;Amberg;41970;Bayern;837,2232196;23,43817012;0;27890;18055;17070;7245;10810;25300;44960;0,56272242;43845;1044,674768;79,04;15;18
09362;Regensburg;152610;Bayern;1887,336137;17,11683376;0;125582;79839;65546;19848;59991;99687;191128;0,521571931;626210;4103,335299;81,1;20;35
09363;Weiden i.d. OPf.;42520;Bayern;602,5223183;23,19849483;0;28272;18239;16944;6924;11315;25163;45216;0,556506546;42833;1007,361242;79,14;15;23
09371;Amberg-Sulzbach;103109;Bayern;82,1042657;21,02629256;0;29319;10497;44259;25454;-14957;35951;73578;0,488610726;125848;1220,53361;80,69;15;18
09372;Cham;127882;Bayern;83,75763847;21,21017813;0;53882;12815;54061;13025;-210;25840;107943;0,239385602;480059;3753,921584;80,33;10;6
09373;Neumarkt i.d. OPf.;133561;Bayern;99,38018066;19,02576351;0;51370;12982;58665;20310;-7328;33292;110035;0,302558277;230342;1724,620211;80,64;15;21
09374;Neustadt a.d. Waldnaab;94352;Bayern;66,08763869;20,94391216;0;32029;12979;39677;20639;-7660;33618;71706;0,46883106;119539;1266,947177;79,97;15;23
09375;Regensburg;193572;Bayern;139,0923201;19,30031203;0;49274;21833;84130;56720;-34887;78553;133404;0,588835417;195118;1007,986692;81,84;20;35
09376;Schwandorf;147189;Bayern;100,9284465;20,53142558;0;56630;16900;64183;24477;-7577;41377;120813;0,342487977;148366;1007,996521;80,07;10;18
09377;Tirschenreuth;72504;Bayern;66,87080351;22,6884034;0;26508;8898;29905;12314;-3416;21212;56413;0,376012621;119294;1645,343705;79,63;17;23
09461;Bamberg;77592;Bayern;1420,578543;19,13470461;0;54478;37322;29512;12377;24945;49699;83990;0,591725205;394333;5082,134756;79,96;15;21
09462;Bayreuth;74657;Bayern;1116,116011;21,42732765;0;48024;29036;27594;8619;20417;37655;75618;0,497963448;191823;2569,39068;80,08;17;27
09463;Coburg;41249;Bayern;854,1934148;23,47450847;0;33948;23859;17096;7027;16832;30886;51044;0,605085808;72069;1747,169628;79,62;8,6;5
09464;Hof;45930;Bayern;791,6235781;23,95166558;0;24739;14435;17461;7172;7263;21607;42200;0,512014218;88343;1923,426954;78,75;14;15
09471;Bamberg;147086;Bayern;125,9492045;19,02492419;0;40135;16951;65651;42488;-25537;59439;105786;0,561879644;217783;1480,650776;80,14;15;21
09472;Bayreuth;103656;Bayern;81,38563487;22,39233619;0;24249;9321;43886;28966;-19645;38287;68135;0,561928524;261223;2520,095315;80,43;17;27
09473;Coburg;86906;Bayern;147,1960163;23,05479484;0;29198;13618;38367;22812;-9194;36430;67565;0,539184489;80430;925,4827055;80,54;8,6;5
09474;Forchheim;116099;Bayern;180,6144991;20,22670307;0;32462;12049;50892;30491;-18442;42540;83354;0,510353432;159391;1372,888655;81,03;15;16
09475;Hof;95311;Bayern;106,7874469;25,71896213;0;38271;16218;38027;15998;220;32216;76298;0,422239115;127144;1333,99083;80,27;14;15
09476;Kronach;67135;Bayern;103,0452334;24,1736799;0;26000;6942;28819;9792;-2850;16734;54819;0,305259125;71000;1057,570567;79,81;15;19
09477;Kulmbach;71845;Bayern;109,1338559;24,07265641;0;28148;9213;30780;11854;-2641;21067;58928;0,357504073;116368;1619,709096;80,25;15;19
09478;Lichtenfels;66838;Bayern;128,554393;22,56949639;0;28890;10376;29240;10740;-364;21116;58130;0,363254774;194301;2907,043897;79,61;15;19
09479;Wunsiedel i. Fichtelgebirge;73178;Bayern;120,6820918;26,36448113;0;29761;9525;28336;8111;1414;17636;58097;0,303561285;145363;1986,430348;79,09;17;15
09561;Ansbach;41847;Bayern;418,8469623;21,23210744;0;27809;17967;17403;7578;10389;25545;45212;0,565004866;40027;956,5082324;79,58;18;28
09562;Erlangen;111962;Bayern;1454,807692;17,67117415;0;91977;62816;48502;19369;43447;82185;140479;0,585034062;258203;2306,166378;81,6;17;16
09563;F++rth;127748;Bayern;2016,543015;18,30635313;0;48770;32234;57298;40790;-8556;73024;106068;0,688464004;151887;1188,957948;79,99;17;25
09564;N++rnberg;518365;Bayern;2780,182355;20,07330742;0;314648;162863;223316;71715;91148;234578;537964;0,436047765;2001217;3860,632952;80,34;22;32
09565;Schwabach;40792;Bayern;999,8039216;21,81310061;0;16939;11330;17027;11426;-96;22756;33966;0,669964082;51187;1254,829378;79,84;15;21
09571;Ansbach;183949;Bayern;93,31307608;20,03218283;0;62774;16739;80586;34582;-17843;51321;143360;0,357986886;728791;3961,918793;80,98;18;28
09572;Erlangen-H+Âchstadt;136271;Bayern;241,3627588;20,39025178;0;53277;31010;60180;37954;-6944;68964;113457;0,607842619;179325;1315,943965;81,9;17;16
09573;F++rth;117387;Bayern;381,8332629;22,81342908;0;25693;13657;49852;37829;-24172;51486;75545;0,681527566;118524;1009,685911;81,11;17;25
09574;N++rnberger Land;170365;Bayern;213,0920962;22,25515804;0;55808;22506;71938;38658;-16152;61164;127746;0,478793857;199712;1172,25956;80,85;22;32
09575;Neustadt a.d. Aisch-Bad Windsheim;100364;Bayern;79,18639147;20,84113826;0;33965;8884;43825;18757;-9873;27641;77790;0,355328448;193628;1929,257503;81,1;18;11
09576;Roth;126958;Bayern;141,8287438;20,78482648;0;40253;15971;54573;30310;-14339;46281;94826;0,488062346;196099;1544,597426;81,07;15;21
09577;Wei+enburg-Gunzenhausen;94393;Bayern;97,23418282;21,75690994;0;33128;7066;39534;13479;-6413;20545;72662;0,282747516;249428;2642,441706;80,48;15;15
09661;Aschaffenburg;70527;Bayern;1129,335468;20,80338027;0;47029;33171;29410;15571;17600;48742;76439;0,637658787;100673;1427,439137;80,1;16;25
09662;Schweinfurt;54032;Bayern;1513,501401;23,46202251;0;53899;40764;20702;7574;33190;48338;74601;0,647953781;123506;2285,793604;79,46;17;21
09663;W++rzburg;127880;Bayern;1459,817352;19,95073506;0;92172;58241;52980;19070;39171;77311;145152;0,532620977;614024;4801,563966;81,45;20;30
09671;Aschaffenburg;174208;Bayern;246,8514425;21,45768277;0;53407;23989;73090;43702;-19713;67691;126497;0,53511941;279724;1605,68975;81,93;16;25
09672;Bad Kissingen;103218;Bayern;90,78739049;24,40659575;0;35580;9800;42156;16387;-6587;26187;77736;0,336870948;435481;4219,041252;81,03;17;21
09673;Rh+Ân-Grabfeld;79690;Bayern;77,99592843;22,12699209;0;32963;9298;33776;10121;-823;19419;66739;0,290969298;242601;3044,309198;80,48;11;7
09674;Ha+berge;84599;Bayern;88,47509386;20,74492606;0;28530;8088;36419;15981;-7893;24069;64949;0,370583073;116856;1381,292923;80,59;17;21
09675;Kitzingen;90909;Bayern;132,8748703;20,63492063;0;34128;11151;39122;16159;-5008;27310;73250;0,372832765;405882;4464,706465;80,99;15;30
09676;Miltenberg;128756;Bayern;179,9399064;21,27900836;0;44347;13320;54139;23133;-9813;36453;98486;0,370133826;158205;1228,719438;81,31;15;15
09677;Main-Spessart;126365;Bayern;95,64193971;22,87342223;0;47580;12879;54795;20103;-7224;32982;102375;0,322168498;243146;1924,156214;81,4;15;6
09678;Schweinfurt;115106;Bayern;136,8061993;21,69826073;0;26823;12017;49719;34918;-22901;46935;76542;0,613192757;54736;475,5269056;81,81;17;21
09679;W++rzburg;161834;Bayern;167,1269092;21,26314619;0;40189;19526;67740;47088;-27562;66614;107929;0,617202049;256840;1587,058344;82,63;20;30
09761;Augsburg;295135;Bayern;2009,771876;19,42365358;0;147489;75198;123488;51263;23935;126461;270977;0,466685364;478115;1619,987463;80,82;18;25
09762;Kaufbeuren;43893;Bayern;1096,776612;22,87836329;0;19124;9970;18121;8978;992;18948;37245;0,508739428;49563;1129,177773;80,37;6,8;19
09763;Kempten (Allg+ñu);68907;Bayern;1088,92225;22,15449809;0;37186;21568;28813;13212;8356;34780;65999;0,526977681;187609;2722,640661;80,92;6,8;19
09764;Memmingen;43837;Bayern;625,2603052;21,60047449;0;31171;19756;18780;7384;12372;27140;49951;0,543332466;111396;2541,141045;80,67;14;16
09771;Aichach-Friedberg;133596;Bayern;171,2264332;19,82394682;0;37086;16281;56512;35740;-19459;52021;93598;0,55579179;124216;929,788317;82,03;22;37
09772;Augsburg;251534;Bayern;234,9357867;20,49742778;0;77553;36425;105432;64364;-27939;100789;182985;0,550804711;224591;892,8852561;81,66;16;24
09773;Dillingen a.d. Donau;96021;Bayern;121,2034384;20,1362202;0;34429;9465;42008;17060;-7595;26525;76437;0,347017806;90161;938,9716833;81,21;16;36
09774;G++nzburg;125747;Bayern;164,9292394;19,38256976;0;53855;15393;56716;18286;-2893;33679;110571;0,30459162;566168;4502,437434;81,05;16;27
09775;Neu-Ulm;174200;Bayern;337,6885201;20,19804822;0;67004;29796;76747;39575;-9779;69371;143751;0,482577513;290778;1669,219288;82,07;16;27
09776;Lindau (Bodensee);81669;Bayern;252,5480858;22,598538;0;33008;10574;32549;10143;431;20717;65557;0,316015071;567593;6949,919798;81,48;14;22
09777;Ostallg+ñu;140316;Bayern;100,6253406;21,106645;0;49247;15657;58258;24707;-9050;40364;107505;0,375461606;1187008;8459,534194;82;6,8;19
09778;Unterallg+ñu;144041;Bayern;117,1493636;21,01484994;0;52433;18491;62803;28897;-10406;47388;115236;0,411225659;310896;2158,38546;81,79;14;19
09779;Donau-Ries;133496;Bayern;104,7380685;19,84404027;0;62714;18050;59334;14700;3350;32750;122048;0,268337048;178388;1336,279739;81,66;14;15
09780;Oberallg+ñu;155362;Bayern;101,6800288;22,66062486;0;55758;16018;64723;25086;-9068;41104;120481;0,341165827;1559808;10039,82956;82,41;6,8;8
10041;Regionalverband Saarbr++cken;329708;Saarland;802,30685;22,94939765;0;153163;69455;119924;36292;33163;105747;273087;0,387228246;353760;1072,949398;79,33;15;21
10042;Merzig-Wadern;103366;Saarland;185,689649;22,67476733;0;31659;12238;34709;15307;-3069;27545;66368;0,415034354;187756;1816,419326;79,44;12;8
10043;Neunkirchen;132206;Saarland;529,2473979;24,37786485;0;39854;18943;50227;29334;-10391;48277;90081;0,535928775;53934;407,9542532;79,21;19;28
10044;Saarlouis;195201;Saarland;424,9504735;23,94301259;0;72992;28014;74570;29634;-1620;57648;147562;0,390669685;101990;522,4870774;79,9;16;16
10045;Saarpfalz-Kreis;142631;Saarland;340,994071;24,98615308;0;66370;35872;55046;24579;11293;60451;121416;0,49788331;110697;776,1075783;80,75;19;14
10046;St. Wendel;87397;Saarland;183,5801458;24,63013605;0;27330;10120;33846;16647;-6527;26767;61176;0,437540866;265728;3040,470497;80,54;19;28
11001;Berlin Mitte;384172;Berlin;9733,265771;12,74041157;1;.;.;.;.;.;NA;NA;0,179148152;5732248;14921,04578;80,74;18;25
11002;Berlin Friedrichshain-Kreuzberg;289762;Berlin;14245,91937;10,02075263;0;.;.;.;.;.;NA;NA;0,179148152;1668654;5758,70542;80,74;19;23
11003;Berlin Pankow;407765;Berlin;3955,043647;14,89808102;1;.;.;.;.;.;NA;NA;0,179148152;523334;1283,420598;80,74;17;14
11004;Berlin Charlottenburg-Wilmersdorf;342332;Berlin;5289,431397;23,35062858;0;.;.;.;.;.;NA;NA;0,179148152;2747572;8026,044892;80,74;16;48
11005;Berlin Spandau;243977;Berlin;30383,18804;21,96190555;0;.;.;.;.;.;NA;NA;0,179148152;259017;1061,645155;80,74;15;13
11006;Berlin Steglitz-Zehlendorf;308697;Berlin;3011,678049;25,78673513;0;.;.;.;.;.;NA;NA;0,179148152;210769;682,7698358;80,74;16;13
11007;Berlin Tempelhof-Sch+Âneberg;351644;Berlin;6623,544924;20,92371432;0;.;.;.;.;.;NA;NA;0,179148152;823926;2343,068558;80,74;22;39
11008;Berlin Neuk+Âlln;329691;Berlin;7337,881148;17,50134528;0;.;.;.;.;.;NA;NA;0,179148152;403625;1224,252406;80,74;22;40
11009;Berlin Treptow-K+Âpenick;271153;Berlin;1610,172209;22,20591233;1;.;.;.;.;.;NA;NA;0,179148152;327712;1208,587034;80,74;16;11
11010;Berlin Marzahn-Hellersdorf;268548;Berlin;4345,436893;20,02761043;1;.;.;.;.;.;NA;NA;0,179148152;83131;309,5573231;80,74;24;18
11011;Berlin Lichtenberg;291452;Berlin;5573,761714;19,54332807;1;.;.;.;.;.;NA;NA;0,179148152;498068;1708,919479;80,74;24;35
11012;Berlin Reinickendorf;265225;Berlin;2964,070183;23,58680794;0;.;.;.;.;.;NA;NA;0,179148152;224496;846,4360449;80,74;18;11
12051;Brandenburg an der Havel;72124;Brandenburg;313,9784946;27,54422938;1;29679;11988;27528;9860;2128;21848;57207;0,381911305;97694;1354,528312;79,71;20;23
12052;Cottbus;100219;Brandenburg;605,0775826;25,38540596;1;46162;22027;37295;13174;8853;35201;83457;0,421786069;146108;1457,887227;79,89;18;26
12053;Frankfurt (Oder);57873;Brandenburg;391,4305039;25,78922814;1;28703;14167;21376;6854;7313;21021;50079;0,419756784;59536;1028,735334;79,54;17;12
12054;Potsdam;178089;Brandenburg;946,0239044;19,68903189;1;86168;49621;72042;35557;14064;85178;158210;0,53838569;550173;3089,314893;81,67;17;15
12060;Barnim;182760;Brandenburg;123,5190354;23,6288028;1;50446;17354;74388;41346;-23992;58700;124834;0,470224458;261933;1433,207485;80,3;19;22
12061;Dahme-Spreewald;169067;Brandenburg;74,33052103;24,05141157;1;62848;31140;69994;38291;-7151;69431;132842;0,522658497;840874;4973,614011;81,19;14;7
12062;Elbe-Elster;102638;Brandenburg;54,04389309;27,96430172;1;33399;6708;39873;13343;-6635;20051;73272;0,2736516;58645;571,3770728;79,48;16;12
12063;Havelland;161909;Brandenburg;93,73476678;22,39591375;1;45078;14905;66003;35879;-20974;50784;111081;0,457179896;121081;747,8336596;80,14;17;12
12064;M+ñrkisch-Oderland;194328;Brandenburg;90,022931;23,86840805;1;51294;19212;76953;44890;-25678;64102;128247;0,499832355;200149;1029,95451;80,67;18;9
12065;Oberhavel;211249;Brandenburg;116,8302759;22,85170581;1;58000;19532;85618;47233;-27701;66765;143618;0,464879054;227295;1075,957756;80,3;16;13
12066;Oberspreewald-Lausitz;110476;Brandenburg;90,29800729;28,62884246;1;41065;14698;42799;16452;-1754;31150;83864;0,371434704;272848;2469,749086;79,12;18;9
12067;Oder-Spree;178658;Brandenburg;79,16605738;26,40687795;1;55955;16730;70168;30960;-14230;47690;126123;0,378122943;437844;2450,738282;80,44;17;12
12068;Ostprignitz-Ruppin;99078;Brandenburg;39,21473947;25,36789196;1;35649;7470;38477;10709;-3239;18179;74126;0,245244584;332376;3354,690244;79,59;16;13
12069;Potsdam-Mittelmark;214664;Brandenburg;82,8159842;22,40384974;1;61718;30497;86625;55461;-24964;85958;148343;0,579454373;448660;2090,057019;81,63;13;7
12070;Prignitz;76508;Brandenburg;35,77514051;28,09248706;1;27177;5475;29271;7602;-2127;13077;56448;0,231664541;126828;1657,708998;79,09;14;9
12071;Spree-Nei+e;114429;Brandenburg;69,05876957;27,80414056;1;36671;14144;44121;21624;-7480;35768;80792;0,442717101;273165;2387,200797;79,68;16;12
12072;Teltow-Fl+ñming;168296;Brandenburg;79,9802302;22,46933973;1;64986;30234;71943;37250;-7016;67484;136929;0,492839355;260118;1545,598232;80,39;17;14
12073;Uckermark;119552;Brandenburg;38,85330239;27,56039213;1;39166;6230;43216;10300;-4070;16530;82382;0,200650628;339803;2842,302931;79,56;17;10
13003;Rostock;208886;Mecklenburg-Vorpommern;1151,775474;23,8527235;1;92514;34543;80987;23031;11512;57574;173501;0,331836704;818282;3917,361623;80,84;16;9
13004;Schwerin;95818;Mecklenburg-Vorpommern;734,1250383;25,5536538;1;50834;25668;35723;10561;15107;36229;86557;0,418556558;209079;2182,04304;79,76;18;16
13071;Mecklenburgische Seenplatte;259130;Mecklenburg-Vorpommern;47,15218147;25,72376799;1;94162;13066;97822;16753;-3687;29819;191984;0,155320235;1050403;4053,575425;80,04;17;17
13072;Rostock;215113;Mecklenburg-Vorpommern;62,69213059;23,7847085;1;68933;21737;83784;36615;-14878;58352;152717;0,382092367;1151835;5354,557837;80,23;15;7
13073;Vorpommern-R++gen;224684;Mecklenburg-Vorpommern;69,8774647;25,99962614;1;75381;8968;84562;18169;-9201;27137;159943;0,169666694;2229504;9922,842748;79,8;18;17
13074;Nordwestmecklenburg;156729;Mecklenburg-Vorpommern;73,68374039;23,5068175;1;48179;10357;63363;25550;-15193;35907;111542;0,321914615;643147;4103,560924;80,02;19;16
13075;Vorpommern-Greifswald;236697;Mecklenburg-Vorpommern;59,99041966;25,06242158;1;82988;13241;86999;17280;-4039;30521;169987;0,179549024;1392886;5884,679569;79,23;19;25
13076;Ludwigslust-Parchim;212618;Mecklenburg-Vorpommern;44,60402074;23,70119181;1;65857;13268;88315;35736;-22468;49004;154172;0,317852788;379063;1782,835884;79,78;15;8
14511;Chemnitz;247237;Sachsen;1118,46641;27,76323932;1;117159;51919;93044;27847;24072;79766;210203;0,379471273;267116;1080,404632;80,72;18;33
14521;Erzgebirgskreis;337696;Sachsen;184,7453362;29,41314081;1;115753;18775;132730;35793;-17018;54568;248483;0,21960456;611082;1809,562447;80,44;14;18
14522;Mittelsachsen;306185;Sachsen;144,6418027;28,03435831;1;109923;27688;122217;40014;-12326;67702;232140;0,291642974;292258;954,5144276;80,86;14;21
14523;Vogtlandkreis;227796;Sachsen;161,2772134;29,96540765;1;82209;14067;88510;21095;-7028;35162;170719;0,205964187;348893;1531,602838;80,08;14;21
14524;Zwickau;317531;Sachsen;334,3276196;29,19179545;1;125462;32519;127402;34582;-2063;67101;252864;0,26536399;249467;785,6461259;80,01;17;22
14612;Dresden;554649;Sachsen;1688,532026;21,85129695;1;269422;96812;228999;56466;40346;153278;498421;0,307527171;2247007;4051,223386;82,3;18;27
14625;Bautzen;300880;Sachsen;125,5964034;27,35841532;1;113660;29256;120193;35824;-6568;65080;233853;0,278294484;276778;919,8949747;80,72;15;14
14626;G+Ârlitz;254894;Sachsen;120,7215997;29,54012256;1;86989;12784;92487;18313;-5529;31097;179476;0,173265506;440782;1729,275699;80,12;14;8
14627;Mei+en;242165;Sachsen;166,4833389;27,42303801;1;90385;29665;96601;35932;-6267;65597;186986;0,35081236;346604;1431,272067;81,35;14;11
14628;S+ñchsische Schweiz-Osterzgebirge;245611;Sachsen;148,4781071;27,43932479;1;80097;24445;98695;42920;-18475;67365;178792;0,376778603;751778;3060,848252;81,15;18;35
14713;Leipzig;587857;Sachsen;1973,999328;20,44902077;1;272873;97724;240794;65824;31900;163548;513667;0,318393045;1836797;3124,564307;80,58;21;34
14729;Leipzig;257763;Sachsen;156,0960692;26,4165144;1;78845;28007;104375;53572;-25565;81579;183220;0,44525161;238426;924,9814752;80,81;15;17
14730;Nordsachsen;197673;Sachsen;97,44546597;25,61705443;1;74385;30436;81917;38043;-7607;68479;156302;0,438119794;271825;1375,124574;80,2;12;8
15001;Dessau-Ro+lau;81237;Sachsen-Anhalt;331,9725389;31,38594483;1;33890;13304;30079;9967;3337;23271;63969;0,363785584;122642;1509,681549;79,88;16;16
15002;Halle (Saale);239257;Sachsen-Anhalt;1771,880323;24,13806075;1;97378;40785;87170;30783;10002;71568;184548;0,387801548;254159;1062,284489;79,42;23;36
15003;Magdeburg;238697;Sachsen-Anhalt;1187,488185;24,2512474;1;108684;44133;93708;29368;14765;73501;202392;0,363161587;405777;1699,966904;80,07;20;29
15081;Altmarkkreis Salzwedel;83765;Sachsen-Anhalt;36,5251706;24,15806124;1;27279;5973;35297;14016;-8043;19989;62576;0,319435566;98342;1174,022563;78,79;12;6
15082;Anhalt-Bitterfeld;159854;Sachsen-Anhalt;109,9552211;27,75720345;1;56412;16671;61469;23650;-6979;40321;117881;0,342048337;120324;752,7118496;79,09;16;16
15083;B+Ârde;171734;Sachsen-Anhalt;72,55589543;23,66042834;1;61941;22710;73639;34519;-11809;57229;135580;0,42210503;173334;1009,316734;79,72;15;16
15084;Burgenlandkreis;180190;Sachsen-Anhalt;127,4553492;27,87224596;1;59472;13185;72645;26469;-13284;39654;132117;0,300143055;260715;1446,889395;79,6;15;15
15085;Harz;214446;Sachsen-Anhalt;101,8866849;28,09798271;1;73283;9502;84459;22083;-12581;31585;157742;0,200232024;1003185;4678,030833;78,99;21;29
15086;Jerichower Land;89928;Sachsen-Anhalt;57,0269002;25,75838449;1;27828;8550;35888;16754;-8204;25304;63716;0,397137297;80721;897,6180945;79,21;15;11
15087;Mansfeld-S++dharz;136249;Sachsen-Anhalt;94,03421835;29,43874817;1;41939;8792;50105;17021;-8229;25813;92044;0,280441963;167668;1230,599858;79,62;13;25
15088;Saalekreis;184582;Sachsen-Anhalt;128,7254519;25,58971081;1;69670;33778;76706;41280;-7502;75058;146376;0,512775318;223790;1212,415078;79,78;16;16
15089;Salzlandkreis;190560;Sachsen-Anhalt;133,5080185;27,87993283;1;62749;15110;72219;25220;-10110;40330;134968;0,29881157;138316;725,8396306;78,41;16;16
15090;Stendal;111982;Sachsen-Anhalt;46,20844182;25,47195085;1;35664;6121;42749;13319;-7198;19440;78413;0,247918075;142354;1271,222161;78,77;14;10
15091;Wittenberg;125840;Sachsen-Anhalt;65,18586051;28,53146853;1;43210;7600;50701;15399;-7799;22999;93911;0,244902088;241359;1917,983153;79,08;15;10
16051;Erfurt;213699;Th++ringen;791,7416917;22,19242954;1;108960;47698;85272;24244;23454;71942;194232;0,370392108;504212;2359,449506;80,86;17;27
16052;Gera;94152;Th++ringen;618,6883953;28,97017589;1;36721;15532;34636;13477;2055;29009;71357;0,406533346;104524;1110,162291;80,01;15;28
16053;Jena;111407;Th++ringen;970,6979176;21,27424668;1;57455;26448;42334;11378;15070;37826;99789;0,379059816;198505;1781,800066;81,95;14;25
16054;Suhl;34835;Th++ringen;338,1054062;32,24343333;1;15947;8472;13896;6439;2033;14911;29843;0,499648159;91087;2614,812688;79,08;13;22
16055;Weimar;65090;Th++ringen;770,4782197;22,96051621;1;24383;12280;23825;11757;523;24037;48208;0,498610189;394516;6061,084652;80,02;13;15
16056;Eisenach;42370;Th++ringen;406,7389844;25,87915978;1;22812;12469;17002;7032;5437;19501;39814;0,489802582;201388;4753,080009;78,98;14;13
16061;Eichsfeld;100380;Th++ringen;106,4384782;23,66507272;1;36181;9776;42128;15761;-5985;25537;78309;0,326105556;116130;1156,903766;81,27;14;10
16062;Nordhausen;83822;Th++ringen;117,412559;26,34988428;1;29872;6877;32381;9412;-2535;16289;62253;0,261658073;79623;949,9057527;79,34;14;17
16063;Wartburgkreis;123025;Th++ringen;94,09465682;25,40052835;1;41218;14308;48738;23231;-8923;37539;89956;0,417304015;135088;1098,053241;80,18;14;13
16064;Unstrut-Hainich-Kreis;102912;Th++ringen;105,0465458;25,07093439;1;35878;8513;41350;14044;-5531;22557;77228;0,292083182;119606;1162,216262;79,47;15;14
16065;Kyffh+ñuserkreis;75009;Th++ringen;72,27066452;27,28472583;1;20076;4512;28285;12840;-8328;17352;48361;0,358801514;106940;1425,695583;78,16;10;5
16066;Schmalkalden-Meiningen;122347;Th++ringen;101,0522577;26,43383164;1;44278;11029;52252;19041;-8012;30070;96530;0,311509375;266952;2181,92518;79,5;11;7
16067;Gotha;135452;Th++ringen;144,7013076;25,07677997;1;50521;12528;56688;18795;-6267;31323;107209;0,292167635;334024;2465,995334;79,94;17;30
16068;S+Âmmerda;69655;Th++ringen;86,32634345;24,55100136;1;23933;9707;27230;13341;-3634;23048;51163;0,450481793;28815;413,681717;78,8;13;14
16069;Hildburghausen;63553;Th++ringen;67,72268576;24,89890328;1;19457;4704;28012;13297;-8593;18001;47469;0,379215909;94846;1492,392177;79,57;13;29
16070;Ilm-Kreis;108742;Th++ringen;128,8824624;25,79224219;1;38521;11113;42638;15379;-4266;26492;81159;0,326420976;156608;1440,179507;80,15;10;3
16071;Weimarer Land;81947;Th++ringen;101,8620492;23,93010116;1;26037;10770;34249;19027;-8257;29797;60286;0,494260691;167374;2042,466472;79,91;16;28
16072;Sonneberg;56196;Th++ringen;129,6003321;27,749306;1;21720;6784;24170;9596;-2812;16380;45890;0,35694051;58099;1033,86362;78,76;8,6;5
16073;Saalfeld-Rudolstadt;106356;Th++ringen;102,657259;29,03456317;1;35676;6153;40789;11946;-5793;18099;76465;0,236696528;160280;1507,014179;80,05;15;28
16074;Saale-Holzland-Kreis;83051;Th++ringen;101,8718185;25,84797293;1;26958;11034;34267;18380;-7346;29414;61225;0,480424663;99598;1199,239022;81,44;14;15
16075;Saale-Orla-Kreis;80868;Th++ringen;70,23876734;26,67804323;1;30109;7573;33979;11468;-3895;19041;64088;0,297107103;100450;1242,147697;79,81;9,8;5
16076;Greiz;98159;Th++ringen;116,0326729;29,17918887;1;30145;10843;38028;18785;-7942;29628;68173;0,434600208;65812;670,463228;80,23;14;28
16077;Altenburger Land;90118;Th++ringen;158,2655731;30,33911094;1;27912;7139;33883;13135;-5996;20274;61795;0,328084797;43698;484,8975787;80,28;14;15
